1111111111111111111111111111
10000000000000000000000000C1
1000000000000000000000000001
100000000000000000000000C001
1111111111111111111111111101
1E00000000000000000000P11101
1000000000000000000000000001
1111111111111111111111111111
