1111111111111111111111111111
1P000000000000000000000000C1
1111111111111111111111111111
100000000000000000000000C001
1111111111111111111111111101
1E00000000000000000000011101
1000000000000000000000000001
1111111111111111111111111111
