11111
10001
1P0C1
1E001
11111
