11111111111111111111
1E1C000000111C000001
10100000000C1C000001
10000000001111111101
10000001110000000001
10000000000000000001
1P0000000C0000000001
11111111111111111111
